w              w               w
w              w               w
w              w               w
w              w               w
w              w               w
w               w              w
w      w         w             w
w     w           w            w
ww           w     w           w
www            w   w           w
w  ww             w            w
w               ww             w
w  w  w     w  w     www       w
w  w       ww  w          w    w
w   ww         w         ww    w
w s     w      w w     wwww    w
w  w     ww    wwww     s      w
wwwwwww wwww   wwwww  wwwwww  ww
